ZZZZZZZZZZZZZZZZZZZZZZZZZZZZZZZZZZZZZZZ
ZZZZZZZZZZZZZZZZZZZZZZZZZZZZZZZZZZZZZZZ
ZZZZZZZZZZZZZZZZZZZZZZZZZZZZZZZZZZZZZZZ
ZZZZZZZZZZZZZZZZZZZZZZZZZZZZZZZZZZZZZZZ
ZZZZZZZZZ1111111111111111111111111ZZZZZ
ZZZZZZZZZ1000000000110000000000001ZZZZZ
ZZZZZZZZZ1011000001110000000000001ZZZZZ
ZZZZZZZZZ10010000000000000N0000001ZZZZZ
Z111111111011000001110000000000001ZZZZZ
Z100000000011000001110111111111111ZZZZZ
Z11110111111111011100000010001ZZZZZZZZZ
Z11110111111111011101010010001ZZZZZZZZZ
Z11000000110101011100000010001ZZZZZZZZZ
Z10000000000000001100000010001ZZZZZZZZZ
Z10000000000000001101010010001ZZZZZZZZZ
Z1100000111010101111101111000111ZZZZZZZ
Z11110111Z1110101Z101111010001ZZZZZZZZZ
Z11111111Z1111111Z111111111111ZZZZZZZZZ
ZZZZZZZZZZZZZZZZZZZZZZZZZZZZZZZZZZZZZZZ
ZZZZZZZZZZZZZZZZZZZZZZZZZZZZZZZZZZZZZZZ
ZZZZZZZZZZZZZZZZZZZZZZZZZZZZZZZZZZZZZZZ
