NO ./src/textures/DarkAbstractBackgrounds_03.png
SO ./src/textures/DarkAbstractBackgrounds_06.png
WE ./src/textures/DarkAbstractBackgrounds_09.png
EA     ./src/textures/DarkAbstractBackgrounds_010.png




F  220,100,0
C 225,30,0

        1111111111111111111111111
        1000000000110000000000001
        10110000011100ls00000000001
        1001000000000000000000001
111111111011000001110000000000001
100000000011000001110111111111111
11110111111111011100000010001
11110111111111011101010010001
11000000110101011100000010001
10000000000000001100000010001
10000000000000001101010010001
11000001110101011111011110N0111
11110111 1110101 101111010001
11111111 1111111 111111111111

1111
10N1
1111

111111
1010N1
111111

0000020000001
1111111111110000000000001
100000000000000000000000
1111111011111111111111111
1000000000110000020000001
1011111111110000000000001
1000000000000000000000001
1111111111111111111111111

1111111211111111111111111
1000000000110000020000001
1111111111110000000000001
1000000000000000000000001
1111111111111111111111111

